111111111111 
010000000000
010000000000
011100111100
000100100100
000111100100
000000000100